+--+--+--+---+
|  .       . |
+  +--+  +   +
|  |  .  |   |
+  +  +--+---+
|  |    .    |
+  +--+--+   +
|        |   |
|      . |   |
+--+--+--+---+